11111111111111111
100100000Z0C10001
10000111110000111
1P0011E0000000001
11111111111111111
